"12","12","12","12","12","12","12","12","12","12","12","12","12"
"-1","-1","12","12","12","12","12","12","12","12","12","12","12"
"12","-1","12","12","12","12","12","12","-1","12","12","12","12"
"-1","12","12","12","12","12","12","-1","12","12","12","-1","12"
"-1","-1","12","12","10","10","10","10","10","12","12","12","12"
"-1","12","12","12","10","10","10","10","10","12","12","12","12"
"12","-1","12","12","10","10","10","10","10","12","12","12","12"
"12","-1","12","12","10","10","10","10","10","12","12","12","12"
"12","-1","12","-1","10","10","10","10","10","12","12","12","-1"
"-1","-1","12","12","-1","12","-1","-1","12","12","12","12","12"
"-1","-1","12","12","-1","12","-1","-1","12","-1","12","12","-1"
"12","-1","12","12","12","12","12","12","12","12","12","12","-1"
"12","-1","12","12","12","12","12","12","12","12","12","-1","-1"
